x.o...x...oox
of.o.x.x.o.fo
.oo..o.o..o..
.o.o.x.x.o.oo
.....x.x.....
.xoxxxoxxxox.
x....opo....x
.xoxxxoxxxox.
.....x.x....o
.o.o.x.x.o.o.
.oo..o.o..o.o
of.o.x.x.oof.
xo.o..x..o.ox
